################################
###****************************#
###****************************#
########*******############****#
###****************************#
####***************************#
####***************************#
####***************************#
###*****###**********###########
###**********************#*#####
###*************************####
###************##***********####
#**************##*************##
##****************************##
###*************************####
################################