################################
###****************************#
###****************************#
########***#***############****#
###****************************#
####***************************#
####***************************#
####***************************#
###*****###**********###########
###**********************#*#####
###****#********************####
###*****#******##***********####
#********#*****##*************##
##********#*******************##
###********#****************####
################################