################################
###****************************#
###****************************#
########*******############****#
###****************************#
####***************************#
####***************************#
####***************************#
###*****###**********###########
###**********************#######
###*************************####
###************##***********####
###************##*************##
#*****************************##
###*************************####
################################
